1111111111111 1111111111111 1111111111111 
1000000000001 1000000000001 1000000000001 
1000000000001 1000000000001 1000000000001 
1000000000001 1000000000001 1000000000001 
1000000000001 1000000000001 1000000000001 
1000000000001 1000000000001 1000000000001 
1000000000001 1000000000001 1000000000001 
1000000000001 1000000000001 1000000000001 
1000000000003 3000000000003 3000000000003 
1000000000001 1000000000001 1000000000001 
1000000000001 1000000000001 1000000000001 
1000000000001 1000000000001 1000000000001 
1000000000001 1000000000001 1000000000001 
1000000000001 1000000000001 1000000000001 
1000000000001 1000000000001 1000000000001 
1000000000001 1000000000001 1000000000001 
1111113111111 1111113111111 1111113111111 
1111111111111 1111111111111 1111113111111 
1000000000001 1000000000001 1000000000001 
1000000000001 1000000000001 1000000000001 
1000000000001 1000000000001 1000000000001 
1000000000001 1000000000001 1000000000001 
1000000000001 1000000000001 1000000000001 
1000000000001 1000000000001 1000000000001 
1000000000001 1000000000001 1000000000001 
1000000000003 3000000000001 1000000000003 
1000000000001 1000000000001 1000000000001 
1000000000001 1000000000001 1000000000001 
1000000000001 1000000000001 1000000000001 
1000000000001 1000000000001 1000000000001 
1000000000001 1000000000001 1000000000001 
1000000000001 1000000000001 1000000000001 
1000000000001 1000000000001 1000000000001 
1111111111111 1111113111111 1111113111111 
1111113111111 1111113111111 1111111111111 
1000000000001 1000000000001 1000000000001 
1000000000001 1000000000001 1000000000001 
1000000000001 1000000000001 1000000000001 
1000000000001 1000000000001 1000000000001 
1000000000001 1000000000001 1000000000001 
1000000000001 1000000000001 1000000000001 
1000000000001 1000000000001 1000000000001 
1000000000001 1000000000001 1000000000003 
1000000000001 1000000000001 1000000000001 
1000000000001 1000000000001 1000000000001 
1000000000001 1000000000001 1000000000001 
1000000000001 1000000000001 1000000000001 
1000000000001 1000000000001 1000000000001 
1000000000001 1000000000001 1000000000001 
1000000000001 1000000000001 1000000000001 
1111113111111 1111111111111 1111113111111 
